0000000000000
0101010101010
0010100001110
0000010110000
0011100000010
0111111100000
0000000000110
0000000000000