0000000000000
0101010101010
1010100001111
0000010110000
0011100000011
1111111100000
0000000000111
1111111111111